XXXXXXXXX0
X0066600X0
X006S600X0
X0066600X0
X0000000X0
X2202022X0
X0000000X0
X2202022X0