0300000300
0400000400
0300000500
0000000000
3000000030
0300000300
0030003000
0003330000