00300000300
00400000400
00300000500
00000000000
03000000030
00300000300
00030003000
00003330000