01001010010
00001010000
01111011110
00000000000
01111011110
00001010000
01001010010
