00000100000
00004040000
04444044440
10000000001
04444044440
00004040000
00004040000
