04444444440
04000000010
04044444440
04000000040
04444440040
00000000030
00000001200
