00000000000
02222022220
00000000000
03333033330
00000000000
02222022220