0000000000
2222022220
0000000000
3333033330
0000000000
2222022220