4444444440
4000000010
4044444440
4000000040
4444440040
0000000030
0000001200
