0XXXXXXXXX0
0X0066600X0
0X006S600X0
0X0066600X0
0X0000000X0
0X2202022X0
0X0000000X0
0X2202022X0