0000100000
0004040000
4444044440
0000000001
4444044440
0004040000
0004040000
